0 0 0 0 0 0 0
0 0 0 0 0 0 0
0 0 0 0 0 0 0
0 0 0 0 0 0 0
2 2 0 0 0 0 0
2 2 2 0 0 0 0
2 2 2 0 0 0 0
2 2 2 0 0 0 0
2 2 2 0 0 0 0
2 2 2 2 2 2 0
0 0 0 0 0 0 0
0 0 0 0 0 0 0
0 0 0 0 0 0 0
0 L L 8 L L L
0 L K K K K L
0 L K K K K L
0 L K K K K L
0 L L 8 L L L
0 0 0 M 0 0 0
0 0 0 M M M 0
0 0 0 0 0 M M
0 0 0 0 0 0 M
L L L L L 0 M
L J J J L 0 M
L J J J L 0 M
L J J J L 0 M
L L 8 L L M M
1 1 M 0 0 M 0
0 0 M 0 M M 0
0 0 M 0 M 0 0
0 0 0 M M 0 0
L L 8 M M 0 0
L H H L M 0 0
L H H L M 0 0
L H H L M 0 0
L L L L M 0 0